###           B     #########
#   ###################   # #
# ####                # # # #
# ################### # # # #
#                     # # # #
##################### # # # #
#   ##                # # # #
# # ## ### ## ######### # # #
# #    #   ##            # #
# # ## ################ # # #
### ##             #### # # #
### ############## ## # # # #
###             ##    #   # #
###### #######   ##### # # #
###### ####    #         #   #
#################### A  #####
